111111111111111111111111
1X0100000000C00000X00001
1C000111111X01010100C001
1P0011E00000C10000010001
111111111111111111111111
111111101111110000011111
111111010111111111011111
11111010111X110000011111
111100000011110111111111
111111011111110000011111
111111111111111111111111