11111111111111
100100000000C1
1C000111111011
1P0011E00000C1
11111111111111