11111111111
100CC00C001
11101111C01
1111110EP01
111111111111